WWWWWWWWWWWWWWWWeWWWWWWWW
W                       W
WWWWW WWWWWWWWWWW WWWWW W
W             W         W
WWWWWWWWWWWWW WWWWWWWWW W
W             W       W W
WWWWWW WWWWWWWW WWWWW W W
W    W W WWWWWW WWWWWWW W
W WW W W              W W
W WW W W WWWWW WWWWWWWW W
W xW   W     W          W
WWWWWWWWWWWWWWWWWWWWWWWWW